....................................................................................................................................
....................................................................................................................................
....................................................................................................................................
.................................#####..........###................##############...........................---....--...............
....................................................................................................................................
........................................####.................................................---...-----............................
.............................#..#...#.........................####.....................---...........................###............
....................................................#####............................................................###............
...............##########...........................#####...........................---..............................###............
1...................................................#####............................................................###....########
##########..........................................#####.......................####.................................###............
.........#..........................................#####............................................................###............
.........#DDDDDDDD####......C.......C........C......#####................A.....A..........A.......A..................###...........X
####################################################################################################################################