............................................................................
............................................................................
........................#...................................................
1...........................................................................
###..#...#...#...#...#.............##....#...#..#..#........................
............................................................................
.......#.......................##...........................................
.........................................................................#..
..#..#....................###............................##.............##..
.........................................................................#..
#.............................................................###...#....#..
.........................................................................#..
...........................................B.............................#.X
############################################################################
############################################################################