########################################################################################################################################################
........................................................................................................................................................
........................................................................................................................................................
........................................................................................................................................................
........................................................................................................................................................
........................................................................................................................................................
......................#....#....#.......................................................................................................................
........................................................................................................................................................
........................................................................................................................................................
...................#....................................................................................................................................
..............................................................................#.........................................................................
.................#......................................................................................................................................
............#..............................................................#............................................................................
1.....#................................................................#...............................................................................X
#.........................................#.....#.....#.....#.....#.................#..................................................................#
########################################################################################################################################################