............................................................................
............................................................................
............................................................................
............................................................................
............................................................................
............................................................................
...........----.............................................................
..........---...............................................................
............................................................................
.......---..................................................................
...---......................................................................
............................................................................
...---......................................................................
1..........................................................................X
############################################################################